медицинские учреждения|медучреждениям
важным моментом|очень значительным моментом
возможно|может быть
итого|в итоге
любой пользователь|абсолютно каждый пользователь
наоборот|и наоборот
необходимо помнить|просто необходимо запомнить
подумайте сами|только вдумайтесь сами
порой|иногда
этот|данный
видный|образный|подобный
°снимите|°сшибите
1|один|одного|первого|одно|одну|одна
10|десять|десяти|десятого|десятый
100|сто
100%|сто процентов
1000|тысячи
10-месячным|десятимесячным
11|одиннадцать|одиннадцатого
13-й|тринадцатый
13-летнего|тринадцатилетнего
14|четырнадцать
14-летняя|четырнадцатилетняя
15|пятнадцати|пятнадцатого|пятнадцать
1600|тысяча шестьсот
17|семнадцати
18-го|восемнадцатого
19-летний|девятнадцатилетний
19-летняя|девятнадцатилетняя
1-ая|первая
1-ое|первое
1-ые|первые
1-ый|первый
2|два|двух
2 месяца|два месяца
2 недели|две недельки
20|двадцатый
200|двесте
2009 года|2009 г.
20-летний|двадцатилетний
25|двадцать пять
2-ая|вторая
2-го|второго
2-го полугодия|второго полугодия
2-м|двум
2-мя|двумя
2-ое|второе
2-ой|второй
2-х|двух
2-ые|вторые
3|три
30|тридцать
300|триста
30-летние|тридцатилетние
30-летних|тридцатилетних
30-летняя|тридцатилетняя
32|тридцать два
37|тридцать семь
39-летний|тридцатидевятилетний
3-ем|третьем
3-ий|третий
3-й|третий
3-мя|тремя
3-х|трех
3-я|третья
4|четыре|четвертого
40|сорок
400|четиреста
41 год|сорок один год
47|сорок семь
4-ая|четвертая
4-мя|четырьмя
4-ого|четвертого
4-ое|четвертое
4-ый|четвертый
4-ыми|четвертыми
5|пятого
50|пятьдесят
500|пятьсот
5-ая|пятая
5-местная|пятиместная
5-местного|пятиместного
5-местном|пятиместном
5-местному|пятиместному
5-местную|пятиместную
5-местный|пятиместный
5-мя|пятерьмя
5-ого|пятого
5-ое|пятое
5-ом|пятом
5-ый|пятый
60|шестьдесят
60-х|шестидесятых
64|шестьдесят четыре
67-летний|шестидесяти семилетний
6-ой|шестой
70|семьдесят
70%|70 процентов
78-летний|семидесяти восьмилетний
7-й|седьмой
8|восьмой
8-летнего|восьмилетнего
8-ми|восьми
90-х|девяностых
9-этажного|девятиэтажного
abs|абс
area|область
Ask|Аск
audi|ауди
bid|бид
Bid|Бид
blazer|блейзер
bmw|бмв
cD|компакт -диски
CD|компакт–диск|компактный диск|компанейский|компакт -диски
chery|черри
chevrolet|шевроле
civilisation|цивилизация
corsa|корса
cамостоятельно|лично
cинонимайзер|программа для синонимизирования статей
cконцентрированным|сосредоточенным
cнегопад|снег
cнижение|понижение
cперва|сначала
cправедливо|объективно
cсправедливо|объективно
cтоимость|цена
distance|расстояние
ferrari|феррари
fora|фора
forex|форекс
Forex|Форекс
general motors|дженерал моторс
god|господь
google|гугл
half|половина
hand|хэнд
horse|конь
hyundai|хэндэ
icq|684718
jaguar|ягуар
knife|нож
lancer|ланцер
lord|лорд
made|мейд
master|мастер
mazda|мазда
mercedes|мерседес
mercedes-benz|мерседес-бенз
mitsubishi|митсубиши
mmonsterr|монстеr
nissan|ниссан
on-line|он-лайн
opel|опель
opinion|мнение
overnight|овернайт
person|личность
premium|премиум
professor|профессор
rain|дождь
region|область
sedan|седан
sitemap|карта сайта
SL|Stop Loss
sport|спорт
spread|спрэд
Spread|Спрэд
stop loss|стоп лосс
stop Loss|sL
Stop Loss|SL
storage|сторидж
subaru|субару
symbian|симбиан
take profit|тэйк профит
take Profit|tP
Take Profit|TP
toyota|тоета
TP|Take Profit
trailing stop|трэйлинг стоп
t-образный|т-образный
USA|США
u-topos|не-место
vectra|вектра
web|интернет
webа|интернета
webе|интернете
webом|интернетом
webу|интернету
week-end|выходные дни
XXI| 21
yahoo|яху
yaris|ярис
y-хромосома|хромосома
zoom-zoom|зум-зум
а|же|да|напротив|но|ан|однако|инак|следовательно|потом|затем|если|когда|коли|буде|же|только|слышишь ли|слушай|отвечай|ась|чего|что (надо(бноть))|говори|ах|ахти|ай|увы|ба|сказывай|да биш|что|аюшки?|в чем дело?|что такое?|что-что|ась?|буква||а также
А|но| однако| же| только| но|однако|же|только
а в|ну а в
а в других|в других же
а в другой|в другой же
а в другом|в другом же
а в случае если|ну а если
а во времена|во времена же
а вообще|короче говоря
а вот|а
а вот для того|а для того
а вот и вы|здравствуйте|с приездом|с приплыздом
а вот и нет|как бы не так|что (ты!|вы!)|ничуть не бывало|(никак|вовсе) нет|(куда|где|какое) там!|да (ты|вы) что!
а всё потому|это происходит в следствии того
а вы не знали|неужели вы еще не знали
а для того|а вот для того
а если|(а) что если|(а) вдруг|того гляди|глядь|глядишь|а ну как|паче чаяния|а что если
а если уж|а уж
а еще|вдобавок|еще|притом
а значит|следовательно
а и|хотя
а именно|как-то|то бишь|например|особенно|в частности|вернее|именно|точнее
а как|как
а как же|(таки) да|о чем парле!|что за вопрос|а то (нет|как же)|спрашиваешь|конечно|о чем разговор|(таки) да|еще бы|(а то|еще бы) нет
а конкретнее|а точнее
а может|быть может
а не|но не
а подчас|а иногда
а потом уж|после чего и
а потому|посему
а поутру они проснулись|с перепоя|перебор|похмелье|перепой|пережор|головка бо-бо|денежки тю-тю|отходняк|бодун|утро добрым не бывает
а раз|если же
а результат?| а где результаты?
а сам|сам же
а сама|сама же
а сами|сами же
а само|само же
а скажем|допустим скажем
а соответственно|ввиду этого
а также|и|а еще|вдобавок|еще|и еще|но также
а там|далее|немного (погодя|спустя)|в дальнейшем|дальше|впоследствии|затем|после (этого)|там|опосля|позднее|потом|позже|с течением времени|через некоторое время|спустя некоторое время|вслед за тем
а теперь|но теперь
а то|(а) не то|в противном случае|иначе|а не то
а то и|а может быть
а то нет|что за вопрос|а (то) как же|еще бы (нет)|конечно|спрашиваешь|таки да|(скажете|скажешь) нет?|ведь верно?|не правда ли?|не так ли?|согласи(те)сь
а точнее|а конкретнее
а тут еще|ко всему еще|вдобавок|(в|на) придачу
а у нас|у нас же
а у него|у него же
а у нее|у нее же
а у них|у них же
а уж|а если уж
а уж тем более|тем паче
а хотите нет|а можете нет
а ху не хо?|а ху-ху не хо-хо?|а хуя не хочешь?|(сосёшь|(по)соси) хуй!|всё равно не будешь!|ну|погоди!|категорическое отрицание
а хуй его знает|а хуй (его не знает|разберет)|не поймешь|не знаю
а что если|а ну как|глядишь|(а|что) если|(а) вдруг|паче чаяния
аа|вода|река|растение
аавасакса|скала
аак|судно|баржа
аал|поселение
аантиб|город|курорт|порт
ааре|река
аарон|имя
Аарон|ковчег Завета
аах|месяц|луна
аба|плащ|река|город
абага|город
абадан|порт|город
абаддон|демон|губитель
абажур|светильник|колпак|плафон|навесец|тенник|затин|щиток|козырек|окно откосом|абажурчик
абажуродержатель|держатель
абажурчик|абажур
абаз|монета
абаза|город
абазия|болезнь
абаим|абдал|обманщик|плут|огудала|оплетала
абай|город
Абай|внимательный|осмотрительный
абак|плита|чертеж|абака
абака|текстильный банан|чертеж|пенька|абак|плита|растение|волокно
абакан|река|хакасск|город|усть-абаканское
Абакан|Хакасск
абактал|пефлацин|перфлокс|лекарство|перти|пефлоксацин|пелокс
абакум|имя
абакумыч|ломик
абан|ангел|поселок|река
абанат|абанус|обанат|обанус|абатур(а)|упрямец|своевольник|неслух|околотень|урос|болван|дурак|наглец|нахал
абандон|отказ
абантуй|сабантуй
аббасиды|династия
аббат|священник|настоятель
аббатиса|настоятельница
аббатовский|аббатский
аббатскo|аббатовскo
аббатская|аббатовская
аббатские|аббатовские
аббатский|аббатовский
аббатским|аббатовским
аббатскими|аббатовскими
аббатских|аббатовских
аббатского|аббатовского
аббатское|аббатовское
аббатской|аббатовской
аббатском|аббатовском
аббатскому|аббатовскому
аббатскую|аббатовскую
аббатство|монастырь
аббревиатура|сокращение|акроним|аббревиация|укорочение|пропуски|означение|письмо под титлами|(сокращенное|условное) обозначение|сложносокращенное слово|абревиатура|фио|акрофут
аббревиация|аббревиатура
абвайзер|обнос
абвахта|пост
абвгдейка|передача
абвер|контрразведка|разведка|оперчасть
абгалдырь|конец|снасть
абгора|виноград
абгратпресс|пресс
абгратштамп|штамп
абдал|плут|обманщик|абаим
абдаста|пистолет
абдерит|глупец|осел|болван|идиот|дурак
абдериты|глупый
абдест|омовение
абдикация|отказ|отречение
абдомен|брюшко
абдоминальный|брюшной
абдоминопластика|операция
абдраган|страх|боязнь|испуг
абдуктор|мышца
абдукция|отведение|ретродукция
Абдула|раб Аллаха
абевега|алфавит|буквица|азбука
абелевскo|абелевo
абелевская|абелевая
абелевские|абелевые
абелевский|абелевый
абелевским|абелевым
абелевскими|абелевыми
абелевских|абелевых
абелевского|абелевого
абелевское|абелевое
абелевской|абелевой
абелевском|абелевом
абелевскому|абелевому
абелевскую|абелевую
абелевый|абелевский
абелизавр|динозавр
абелит|взрывчатка|смесь
абелсонит|минерал
Абель|лёгкое дуновение
абенакиит-се|минерал
аберантный|аберрантный
абергин|бромокриптин
абернатит|минерал
аберрантнo|аберрационнo
аберрантная|аберрационная
аберрантного|аберрационного
аберрантное|аберрационное
аберрантной|аберрационной
аберрантном|аберрационном
аберрантному|аберрационному
аберрантную|аберрационную
аберрантные|аберрационные
аберрантный|аберрационный|аберантный
аберрантным|аберрационным
аберрантными|аберрационными
аберрантных|аберрационных
аберрационный|аберрантный
аберрация|ошибка|обман|хроматизм|самообман|заблуждение|ослепление|обольщение|отклонение|астигматизм|самообольщение
абзац|пункт|конец|фрагмент|часть|труба|амба|финиш|окончание|стих|строка|отпад|отступ|красная строка|(полный)|красная стро(ч)ка|трендец|(песня|песенка) спета|аминь|песец|хана|привет родителям|все|кранты|копец|гамон|германизм|капец|красноречиво|жегшем
абзаца|отступа|жегшем
абзацам|отступам|жегшем
абзацами|отступами|жегшем
абзацах|отступах|жегшем
абзаце|отступе|жегшем
абзацев|отступов|жегшем
абзацем|отступом|жегшему
абзацу|отступу|жегшему
абзацы|отступы|жегшему
абзетцер|экскаватор
абиаль|сплав
абиджан|город|столица
абие|тотчас|вскоре
абиетат|резинат
абиетин|масло
абиогенез|теория
абиогенетический|абиогенный|
абиогеннo|абиогенетическo
абиогенная|абиогенетическая
абиогенного|абиогенетического
абиогенное|абиогенетическое
абиогенной|абиогенетической
абиогенном|абиогенетическом
абиогенному|абиогенетическому
абиогенную|абиогенетическую
абиогенные|абиогенетические
абиогенный|абиогенетический
абиогенным|абиогенетическим
абиогенными|абиогенетическими
абиогенных|абиогенетических
абир|стиль|краска
абиссаль|ложе
абиссальнo|глубиннo
абиссальная|глубинная
абиссального|глубинного
абиссальное|глубинное
абиссальной|глубинной
абиссальном|глубинном
абиссальному|глубинному
абиссальную|глубинную
абиссальные|глубинные
абиссальный|глубоководный|глубинный
абиссальным|глубинным
абиссальными|глубинными
абиссальных|глубинных
абиссинец|зулус|эфиоп
абиссиния|зулуссия|эфиопия
Абиссиния|Эфиопия|Зулуссия
абиссинка|зулуска|эфиопка
абиссинскo|зулусскo
абиссинская|кошка|зулусская
абиссинские|зулусские
абиссинский|зулусский|эфиопский
абиссинским|зулусским
абиссинскими|зулусскими
абиссинских|зулусских
абиссинского|зулусского
абиссинское|зулусское
абиссинской|зулусской
абиссинском|зулусском
абиссинскому|зулусскому
абиссинскую|зулусскую
абитуриент|ученик|претендент|поступающий|выпускник
абитуриента|ученика
абитуриентам|ученикам
абитуриентами|учениками
абитуриентах|учениках
абитуриенте|ученике
абитуриентка|выпускница|претендентка
абитуриентов|учеников
абитуриентом|учеником
абитуриенту|ученику
абихит|минерал
аблакат|адвокат
аблактировавший|сращивавший|прививавший
аблактировавшийся|сращивавшийся|прививавшийся
аблактировал|прививал
аблактировала|прививала
аблактировалась|прививалась
аблактировалася|прививалася
аблактировали|прививали
аблактировались|прививались
аблактировалися|прививалися
аблактировало|прививало
аблактировалось|прививалось
аблактировалося|прививалося
аблактировался|прививался
аблактирование|аблактировка|прививка|сращивание|прививание
аблактированнo|сращеннo
аблактированная|сращенная
аблактированного|сращенного
аблактированное|сращенное
аблактированной|сращенной
аблактированном|сращенном
аблактированному|сращенному
аблактированную|сращенную
аблактированные|сращенные
аблактированный|сращенный|привитый
аблактированным|сращенным
аблактированными|сращенными
аблактированных|сращенных
аблактировать|прививать
аблактироваться|прививаться|сращиваться
аблактировка|прививка|сращивание|аблактирование
аблактируем|прививаем
аблактируемo|прививаемo
аблактируемая|прививаемая
аблактируемого|прививаемого
аблактируемое|прививаемое
евлалия|имя
евлампий|имя
евлампия|имя
Евласая|благосклонная
Евласий|благосклонный|милостевый
Евласого|благосклонного
Евласое|благосклонное
Евласой|благосклонной
Евласом|благосклонном
Евласому|благосклонному
Евласую|благосклонную
Евласые|благосклонные
Евласым|благосклонным
Евласыми|благосклонными
Евласых|благосклонных
евлах|город
евлимена|нереида
евлогий|имя
евмен|имя
евменида|эриния|богиня
Евменида|Эриния
евмений|имя
евмолпа|нереида
евника|нереида
евнух|слуга|прислужник|скопец|кастрат|гаремщик|каженик
евнухоидизм|дисгенитализм|синдром
евня|клуня|овин
Евод|хороший путь
Евпатая|чувствительная
Евпатий|чувствительный|благочестивый
Евпатого|чувствительного
Евпатое|чувствительное
Евпатой|чувствительной
Евпатом|чувствительном
Евпатому|чувствительному
евпатория|порт|город|курорт
евпатрид|эвпатрид
евпатрида|эвпадрида|знать
Евпатрида|знать|Эвпадрида
Евпатую|чувствительную
Евпатые|чувствительные
Евпатым|чувствительным
Евпатыми|чувствительными
Евпатых|чувствительных
евпомпа|нереида
евпраксия|имя
евр|ветер|эвр
Евр|ветер|Эвр
евражка|джумбура|суслик
евразиер|собака
евразийский|европеидный
евразия|материк|суперконтинент
еврафрика|ассоциация
еврашка|хомяк
евредика|нереида
евреи|иудеи
еврей|шницель|иудей|жид|француз|шлагбаум|израильтянин|иудеянин|жид (вечный|пархатый|ёбаный)|жидовянин|жидок|жидюга|жидюк|жидовище|жидомор|юде|еврейчик|ермолка|кучерявый|горбатый нос|картавый|обрезанный|космополит|сион(ист)|пятая графа|отказник|биробиджанин|правоверный|христопродавец|христострадатель|Иисус|кацман|мойша|абрам|абраша|абрамович|моня|монька|жидоёб|морж|морда жидовская|еврейка|евреянка|жидовка|жидовянка|Сара|жидовята|жиды|жидова|жидовщина|жидовьё|избранный народ|особая нация|притча во языцех|авраамово колено|(сын) израилев|еврейский (ребёнок)|еврейского (вероисповедования|происхождения)|из наших|татами|сабра|сын израиля|сын авраама|сын юриста|рахдонит|сефард|швондер|шмуль|маран|тат|шелом|шини|марран|ашкеназ|ветхозаконник|жидяра|еврюга|лац|выкрест|тележид|эбраэли|порхатый|фалаша|мизрахим|голем|кермик|неокон
Еврей|израильтянин| иудей|иудей
еврейка|ветхозаконница|израильтянка|жидовка|выкрестка|иудейка
еврейскo|иудейскo
еврейская|иудейская
еврейские|иудейские
еврейский|израильский|иудейский|жидовский|кошерный
еврейским|иудейским
еврейскими|иудейскими
еврейских|иудейских
еврейского|иудейского
еврейское|иудейское
еврейской|иудейской
еврейском|иудейском
еврейскому|иудейскому
еврейскую|иудейскую
еврейство|вера|жидовство|иудейство
еврейчик|жиденок
евреянка|еврей
еврибия|богиня
еврик|евро
еврит|гигант|евритион|кентавр|камень
евритион|еврит|кентавр
евро|единица|еврик|валюта
евро/фунт|EUR/GBP
евроакция|акция
евробонд|еврооблигация
евробутылка|бутылка
евровагонка|вагонка
евровалюта|валюта
евровилка|вилка
евродверь|дверь
евродепозит|депозит
евродизайн|дизайн
евродоллар|депозит
еврозона|зона
еврокард|карточка
евроконверт|конверт
еврокредит|кредит
еврокубок|кубок
евролига|лига
еврооблигация|облигация|евробонд
евроокно|окно
европа|спутник|героиня|астероид
Европа|старый континент|Старый Свет
европакет|пакет
европарламент|парламент
европарламентарий|парламентарий
европеидный|евразийский
европейский|общеевропейский
европейский перекресток|Люксембург
европейских и российских|российских и европейских
европейского|евро
европеоидный|кавказоидный
европереходник|переходник
европий|металл|элемент|лантаноид
европоддон|поддон
европолис|полис
европоцентризм|евроцентризм
европоцентристскo|евроцентристскo
европоцентристская|евроцентристская
европоцентристские|евроцентристские
европоцентристский|евроцентристский
европоцентристским|евроцентристским
европоцентристскими|евроцентристскими
европоцентристских|евроцентристских
европоцентристского|евроцентристского
европоцентристское|евроцентристское
европоцентристской|евроцентристской
европоцентристском|евроцентристском
европоцентристскому|евроцентристскому
европоцентристскую|евроцентристскую
европрофиль|профиль
евроремонт|ремонт
еврорынок|рынок
евросоюз|союз
евростандарт|стандарт
евротелефон|телефон
евротоннель|тоннель
евротур|тур
еврофура|фура
евроцентризм|европоцентризм
евроцентристский|европоцентристский
еврочек|чек
еврюга|еврей|жид|жидяра
евсевo|благочестивo
евсевая|благочестивая
Евсевая|благочестивая
евсевий|благочестивый
Евсевий|благочестивый|Евсей|Авсей|Евсейка|Евся|Евсюта|Еся|Сева
евсевого|благочестивого
Евсевого|благочестивого
евсевое|благочестивое
Евсевое|благочестивое
евсевой|благочестивой
Евсевой|благочестивой
евсевом|благочестивом
Евсевом|благочестивом
евсевому|благочестивому
Евсевому|благочестивому
евсевую|благочестивую
Евсевую|благочестивую
евсевые|благочестивые
Евсевые|благочестивые
евсевым|благочестивым
Евсевым|благочестивым
евсевыми|благочестивыми
Евсевыми|благочестивыми
евсевых|благочестивых
Евсевых|благочестивых
евсей|имя
евстафий|имя
евстахиит|болезнь|тубоотит
евстахий|имя
евстигней|имя
Евстигней|добрый знак
Евстихиан|счастливый|преуспевающий
евстолия|имя
евстрат|имя
евстратий|имя
Евстратий|хороший воин
евтерпа|муза
евтихий|имя
евфемизм|эвфемизм|благоречие
евфимий|имя
евфимия|имя
евфония|эвфония
евфория|эйфория
евфрат|река
евфратовский|евфратский|
евфратскo|евфратовскo
евфратская|евфратовская
евфратские|евфратовские
евфратский|евфратовский
евфратским|евфратовским
евфратскими|евфратовскими
евфратских|евфратовских
евфратского|евфратовского
евфратское|евфратовское
евфратской|евфратовской
евфратском|евфратовском
евфратскому|евфратовскому
евфратскую|евфратовскую
евфрозина|имя|грация|богиня
евфросина|радость|богиня|харита
Евфросина|Харита|радость
евфросиния|ефросиния|афросинья|имя
Евфросиния|Ефросиния|Афросинья
евхаристийный|евхаристический
евхаристическo|евхаристийнo
евхаристическая|евхаристийная
евхаристические|евхаристийные
евхаристический|евхаристийный|
евхаристическим|евхаристийным
евхаристическими|евхаристийными
евхаристических|евхаристийных
евхаристического|евхаристийного
евхаристическое|евхаристийное
евхаристической|евхаристийной
евхаристическом|евхаристийном
евхаристическому|евхаристийному
евхаристическую|евхаристийную
евхаристия|литургия|благодать|благодарение|таинство|приобщение|причастие|причащение
евшан|емшан|растение
евший|кусавший|изъедавший|чмаривший|скоромившийся|чавкавший|ажлибавший|завинчивавший|евший-пивший|лакомившийся|хававший|лакавший|заправлявшийся|чуфарившийся|чуфанившийся|истязавший|лупивший|сербавший|мучавший|упрекавший|штрявкавший|чуфаривший|хацавший|хомячивший|чуфанивший|поедавший|чифанивший|мучивший|бирлявший|кормившийся|едавший|тюмкавший|харчившийся|харчевавшийся|хрустевший|чамавший|берлявший|харивший|кусавшийся|разрушавший|хрумавший|наедавшийся|съедавший|шнэцкавший|заговлявшийся|трахавший|разъедавший|убиравший|хряпавший|шамавший|метавший|навертывавший|откушивавший|уписывавший|шававший|уничтожавший|проглатывавший|усиживавший|пробовавший|точивший|подкреплявшийся|питавшийся|мявший|шамкавший|угощавшийся|чамкавший|перекусывавший|скоромничавший|жевавший|поровший|уплетавший|снедавший|столовавшийся|трапезовавший|лопавший|попрекавший|коривший|познававший|поглощавший|клевавший|наворачивавший|закусывавший|пенявший|жаливший|подтачивавший|лындивший|перехватывавший|пристававший|отведывавший|пожиравший|трескавший|укорявший|рубавший|жравший|завтракавший|пиливший|хамавший|полдничавший|трапезничавший|шпынявший|урекавший|заглатывавший|обедавший|ужинавший|хрупавший|глотавший|кушавший|чмыривший|корзавший|грызший|вкушавший|чмуривший|уминавший|хлебавший|зудивший|надоедавший
евший-пивший|евший
евшийся|пожиравшийся|трескавшийся|поглощавшийся|снедавшийся|усиживавшийся|хлебавшийся|уничтожавшийся|уписывавшийся|уплетавшийся|лопавшийся|наворачивавшийся|поедавшийся|грызшийся|проглатывавшийся|глотавшийся|вкушавшийся|уминавшийся
ега|шуба
ёга|живопись
егарнувший|стукнувший|выстреливший|ударивший
егда|когда
егей|растение|тростник
егермейстер|ловчий|чин|обер-егермейстер
егеровский|егерский
егерскo|егеровскo
егерская|егеровская
егерские|егеровские
егерский|егеровский
егерским|егеровским
егерскими|егеровскими
егерских|егеровских
егерского|егеровского
егерское|егеровское
егерской|егеровской
егерском|егеровском
егерскому|егеровскому
егерскую|егеровскую
егерь|солдат|лесник|охотник|охотовед|шассер|загонщик|окладчик|германизм|объездчик
египет|страна
Египет|страна пирамид
египетскo|демотическo
египетская|демотическая
египетская казнь|бедствие|катаклизм|наказание|катастрофа|стихийное бедствие
египетская тьма|темный|тёмный|темнота
египетские|демотические
египетский|демотический
египетский труд|египетская работа|дело|трудоемкий труд|пахота
египетским|демотическим
египетскими|демотическими
египетских|демотических
египетского|демотического
египетское|демотическое
египетской|демотической
египетском|демотическом
египетскому|демотическому
египетскую|демотическую
египт|персонаж
египтопитек|обезьяна|гоминоид
его ведь|ведь его
его величества|его превосходительства
езженного|наезженного
езженное|наезженное
езженной|наезженной
езженном|наезженном
езженному|наезженному
езженную|наезженную
езженные|наезженные
езженный|торный|накатанный|наезженный|проторенный|езжалый
езженным|наезженным
езженными|наезженными
езженных|наезженных
езжено|езжено-переезжено
езженого|наезженного
езженое|наезженное
езженой|наезженной
езженом|наезженном
езженому|наезженному
езжено-переезжено|езжено|
езженую|наезженную
езженые|наезженные
езженый|наезженный|наезжий
езженым|наезженным
езжеными|наезженными
езженых|наезженных
езживавший|посещавший
езжу|приезжаю|заезжаю|наезжаю|разъезжаю|колешу|выезжаю
езиды|секта
езовище|язовище
езовый|язовый|перебойный|закольный|учужный
езус|бог
ей в руки|в её руки
ей ведь|ведь ей
ей ещё далеко|она еще не доросла
ей лично|ей самой
ей предоставлялась возможность|ана могла
ей самой|ей лично
ей-богу|убей меня бог|землю буду есть|клянусь богом|видит бог|отсохни у меня рука|истинный крест|чтоб у меня руки и ноги отсохли|бог свидетель|побей меня гром|истинный бог|клянусь|провалиться мне на этом самом месте|отсохни у меня язык|провались я на этом самом месте|не сойти мне с этого места|с места не сойти|чтоб мне с места не сойти|побей меня бог|лопни мои глаза|действительно|истинный гром|ей-ей|провалиться мне на этом месте|ей-же-ей|как бог|честное слово|право слово|вот те крест|провались я на этом месте|убей меня гром|право|да
ей-ей|да| действительно|действительно|истинно|подлинно|ей-богу|взаправду|воистину|ей-же-ей|право
ей-же-ей|ей-ей|право|ей-богу|клянусь|действительно
ейка|река
ейск|порт|город
ейфория|эйфория
-ейш-|очень
-ек-|малый
еканье|эканье
екатерина|катюша|кэт|катя|котя|имя|катрин|катерина
Екатерина|чистота|незапятнанность|Катерина|Екатеринка|Катя|Катюха|Катюша|Катюра|Катюся|Катюля|Катяха|Катяша|Катёна|Рина|Котя|Катрин|Кэт
екатеринбург|свердловск|город
Екатеринбург|Свердловск
екатеринбургскo|екатеринбуржскo
екатеринбургская|екатеринбуржская
екатеринбургские|екатеринбуржские
екатеринбургский|екатеринбуржский
екатеринбургским|екатеринбуржским
екатеринбургскими|екатеринбуржскими
екатеринбургских|екатеринбуржских
екатеринбургского|екатеринбуржского
екатеринбургское|екатеринбуржское
екатеринбургской|екатеринбуржской
екатеринбургском|екатеринбуржском
екатеринбургскому|екатеринбуржскому
екатеринбургскую|екатеринбуржскую
екатеринбуржский|екатеринбургский
екатериненштадт|маркс|баронск
Екатериненштадт|Маркс|Баронск
екатерининскo|свердловскo
екатерининская|свердловская
екатерининские|свердловские
екатерининский|свердловский
екатерининским|свердловским
екатерининскими|свердловскими
екатерининских|свердловских
екатерининского|свердловского
екатерининское|свердловское
екатерининской|свердловской
екатерининском|свердловском
екатерининскому|свердловскому
екатерининскую|свердловскую
екатеринит|минерал
екатеринка|екатериновка
екатериновка|екатеринка
екатеринодар|краснодар
Екатеринодар|Краснодар
екатеринослав|днепропетровск
екклезиаст|проповедник|книга|екклесиаст
екклесиаст|екклезиаст
екклисиархисса|смотрительница
еклисиарх|смотритель|ключарь
ё-клмн|ё-мое
екнем|сжаем
екнемся|сжаемся
екнет|сжает
екнется|сжается
екните|сжаете
екнитесь|сжаетесь
екну|сжаю
екнувший|сжавшийся|встрепенувшийся|замерший
екнул|сжал
екнула|сжала
екнулася|сжалася
екнули|сжали
екнулися|сжалися
екнуло|сжало
екнулося|сжалося
екнулся|сжался
екнуся|сжаюся
екнут|сжают
екнутся|сжаются
екнуть|сжаться|замереть|сжать
ектения|молитва|моление|ектенья|песнопения|прошение
ектенья|ектения
ектунья|ектуха
ектуха|ектунья
ел|обедал
ела|обедала
елабуга|город
елабужанин|елабужец
елабужец|елабужанин
елань|пастбище|луг|поляна|ялань|алань|лес|река
елась|ебалась
елбан|холм|мыс
елбань|река
елбот|судно
елгава|город
елгоза|егоза|непоседа
елгозивший|егозивший|вертевшийся|суетившийся
елгозящий|вертящийся|суетящийся|егозящий
елда|елдак|член|пенис|хуй|хрен|болт|мальчик|кила|мужской половой орган|причинное место|мужское достоинство|фаллос|мужской член|елдык|убивец|хер|детородный орган|конец|щекотун|ванька-встанька|шишка|достоинство|уд
елдарь|сожитель
елдыга|елдыжник|шеромыжник
елдыживший|вздоривший|елдыжничавший|придиравшийся
елдыжник|елдыга|шеромыжник
елдыжничавший|вздоривший|придиравшийся|елдыживший
елдык|наследство|морковка|перец|кила|елда|достоинство|ванька-встанька|пенис|болт|палка|конец|мальчик|сюнька|самочерный|огурец
еле|медленно|едва|чуть|насилу|натужно|с горем пополам|шель-шевель|едва-едва|кой-как|еле-еле|на честном слове|с грехом пополам|насилу-насилу|кое-как|с трудом|только-только
еле держится|зыбкий|хлипкий|непрочный|ненадежный|неустойчивый|держится на честном слове|шаткий|некрепкий|висит на волоске|висит на ниточке|хлюпкий|утлый
еле дышит|слабого здоровья|нездоровый|стоит на краю гроба|стоит одной ногой в могиле|хилый|слабый|хлипкий|квелый|ветром шатает|плох|от ветра шатается|больной|лежит на смертном одре|смотрит в гроб|совсем плох|хрупкого здоровья|на ладан дышит|дохлый|смотрит в могилу|не жилец на этом свете|не жилец|в чем душа держится|еле-еле душа в теле|много не надышит|в чем только душа держится|стоит на краю могилы|болезненный|хворый|стоит одной ногой в гробу
еле живой|полуживой|полумертвый|пациент скорее жив|чем мертв
еле можаху|ногами мыслете выделывает|бухой|хороший|папа-мама не выговаривает|пьяный|папа-мама сказать не может|ногами мыслете пишет
еле ноги таскает|соплей перешибешь|ноги не носят|на ногах не стоит|ветром качает|плевком перешибешь|соплей перешибить можно|ноги не держат|на ногах едва стоит|бессильный|слабосильный|слабый|плевком перешибить можно|еле ноги передвигает
еле ощутимо|легко|нежно|слабо|едва ощутимо|чуть ощутимо|еле заметно|едва заметно|чуть заметно|слегка
еле ощутимый|едва ощутимый|еле заметный|едва заметный|маленький|чуть ощутимый|чуть заметный|слабый|легкий|нежный|небольшой|незначительный
еле переводить дух|еле переводить дыхание|задыхаться
еле передвигать ноги|расслабнуть|обессилеть|изнемочь|расслабеть|ослабеть|ослабнуть|выдохнуться|потерять силы|сдать|выбиться из сил
еле слышная|практически бесшумная
еле слышно|шепотом|потихоньку|слабо|чуть слышно|тихонько|глухо|на ухо|приглушенно|негромко|себе под нос|тихо|едва слышно|под нос|вполголоса
еле слышные|практически бесшумные
еле слышный|практически бесшумный|чуть слышный|тихий|едва слышный|глухой|приглушенный|заглушенный|негромкий|слабый
еле слышных|практически бесшумных
еле унести ноги|спастись|уцелеть|едва унести ноги|остаться целым и невредимым|остаться в живых
елеазар|имя
елевферий|имя
елевый|еловый
еле-едва-чуть|еле
еле-еле|едва-едва|полегоньку|с грехом пополам|разжевывая слова|шель-шевель|неспешно|заторможенно|потихоньку|влегкую|черепашьим ходом|с горем пополам|только-только|с прохладцей|чуть|неторопливо|кой-как|кое-как|с трудом|еле|шаг за шагом|черепахой|копотливо|неоперативно|как сонная муха|насилу-насилу|лениво|нерасторопно|насилу|медленно|на честном слове|едва|замедленно|не торопясь|не спеша|шаг за шаг|как черепаха|черепашьим шагом|неторопко|мешкотно|в медленном темпе|нога за ногу|медлительно
еле-еле душа в теле|в чем душа держится|болезненный|больной|дохлый|в чем только душа держится|не жилец на этом свете|дни сочтены|много не надышит|недолго надышит|от ветра шатается|еле дышит|как выжатый лимон|хворый|плох|на ладан дышит|не жилец|хрупкого здоровья|без задних ног|в мыле|утомленный|лежит на смертном одре|хлипкий|смотрит в могилу|смотрит в гроб|квелый|слабый|ветром шатает|хилый|слабого здоровья|нездоровый|взмыленный|язык на плече
елей|масло|бальзам|миро
елейнo|вкрадчивo
елейная|вкрадчивая
елейник|лампадка|елейничек
елейничек|елейник|лампадка
елейно|медоточиво|вкрадчиво|сладенько|сладко|слащаво|умильно|приторно|медово
елейного|вкрадчивого
елейное|вкрадчивое
елейной|вкрадчивой
елейном|вкрадчивом
елейному|вкрадчивому
елейность|приторность|сладкость|умильность|медоточивость|вкрадчивость|слащавость
елейную|вкрадчивую
елейные|вкрадчивые
елейный|сахарный|сладкий|умильный|приторный|сладенький|медовый|паточный|слащавый|вкрадчивый|медоточивый| кроткий| льстивый|кроткий|льстивый|переслащенный|сахар-медович
елейным|вкрадчивым
елейными|вкрадчивыми
елейных|вкрадчивых
елек|халат
елена|лена|спутник|героиня|элен|нелли|алена|ирина|ляля|ленок|алёна|имя|астероид|эллен
Елена|избранная|светлая|сияющая|Алёна|Олёна|Еленка|Лена|Ленуша|Ленуся|Леся|Еленя|Ёля|Елюша|Елюся|Люся|Алёнка|Лёна|Лёся|Лёля|Ленок|Элен|Эллен|Нелли
еленам|ленам
еленами|ленами
еленах|ленах
еленая|леная
елене|лене
еленец|можжевельник|жук
еленого|леного
еленое|леное
еленой|леной
еленом|леном
еленому|леному
елену|лену
еленую|леную
елены|лены
еленые|леные
еленым|леным
елеными|леными
еленых|леных
елень|олень|лань
елеонскo|масличнo
елеонская|масличная
елеонские|масличные
елеонский|масличный
елеонским|масличным
елеонскими|масличными
елеонских|масличных
елеонского|масличного
елеонское|масличное
елеонской|масличной
елеонском|масличном
елеонскому|масличному
елеонскую|масличную
елеопомазание|соборование|обряд
елеосвящение|таинство|соборование|треба
елец|дужка|город|кленек|рыба
ели|если|обедали
елизавета|лиза|татьяна|лизавета|имя
Елизавета|клятва Божия|Лизавета|Елисавета|Елизаветка|Вета|Лиля|Лиза|Лизуня|Лизуха|Лизуша|Лизура|Лизута|Лизаветка
елизаветград|кирово|зиновьевск|кировоград|город
Елизаветград|Кировоград|Зиновьевск
елизаветполь|гянджа
Елизаветполь|Гянджа
елизар|имя
Елизар|Бог помог
елик|косуля
еликий|который
елико|насколько|сколько
елико возможно|по мере возможности|в меру сил|посильно|по возможности|по силе возможности|если возможно|насколько возможно|если это возможно|в меру своих сил
еликонида|имя
елисей|имя
Елисей|спасенный Богом|Елис|Елиссей|Елисейка|Лисейка|Елеся|Леся|Еля
елисейскo|загробнo
елисейская|загробная
елисейские|загробные
елисейские поля|рай|иной мир|царство вечности|эдем|элизиум|тот свет|загробный мир|райские кущи|обитель блаженных|царство покоя|лучший мир|парадиз
елисейский|загробный
елисейским|загробным
елисейскими|загробными
елисейских|загробных
елисейского|загробного
елисейское|загробное
елисейской|загробной
елисейском|загробном
елисейскому|загробному
елисейскую|загробную
елистрат|имя
елись|ебались
елица|река
елка|праздник|елочка|ель|елушка
елкая|елочкая
елкие|елочкие
елким|елочким
елкими|елочкими
елких|елочких
елкого|елочкого
елкое|елочкое
елкой|елочкой|в елку|в елочку
елком|елочком
елкому|елочкому
елкую|елочкую
еллин|грек|язычник
елман|острие
елмань|расширение
елнать|река
ело|обедало
еловo|елевo
еловая|елевая
еловка|белка|лисица
елово-березовый|березово-еловый
елового|елевого
еловое|елевое
еловой|елевой
елово-кедровый|кедрово-еловый
елово-липовый|липово-еловый
елово-лиственничный|лиственнично-еловый|елово-лиственный
елово-лиственный|лиственнично-еловый|елово-лиственничный
еловом|елевом
еловому|елевому
елово-пихтовый|пихтово-еловый
елово-сосновый|сосново-еловый
елово-широколиственный|широколиственно-еловый
еловую|елевую
еловые|елевые
еловый|желтый|елевый
еловым|елевым
еловыми|елевыми
еловых|елевых
елогуй|река
елоза|ползун|ерга|ерзунья|бакуня|шныра|зыга|ерзун
елозивший|вертевшийся|ерзавший|ездивший|ажлибавший|ползавший|суетившийся|пресмыкавшийся|ялозивший|егозивший
елозил|ездил
елозила|ездила
елозилася|ездилася
елозили|ездили
елозилися|ездилися
елозило|ездило
елозилося|ездилося
елозился|ездился
елозим|ездим
елозимся|ездимся
елозит|ездит
елозите|ездите
елозитесь|ездитесь
елозится|ездится
елозить|суетиться|ездить|ерзать|ползать
елозу|езжу
елозуся|езжуся
елозят|ездят
елозятся|ездятся
елозящий|суетящийся|ездящий|ерзающий|егозящий|вертящийся|пресмыкающийся|ползающий
елок|рытвина|буерак|долок
еломок|яломок|шапка|ермолка|скуфья
елоп|дурень|елыман|болван|дурак|остолоп
елось|ебалось
елоха|пролаза|проныра|ольха
елочка|елка|ель|елушка|кудрявец|растение|хорошо|правильно
елочкой|елкой
елпидифор|имя
елпидорф|имя
елся|ебался
елтырева|река
елтыш|отрубок|чурбан
елтышный|елтышовый|неколотый|кругляковый
елтышовый|елтышный|неколотый|кругляковый
елуй|бревно|помост
елушка|елка|елочка
елыман|дурень|дурак|елоп|болван
ель|елка|елочка|дерево|зеленая красавица|лесная красавица|хвойные
ельма|сколько|колико
ельник|лес
ельничек|лес
ельня|город|вырубка
ельтма|река
ельшин|оселок
ем|обедаю|употребляю в пищу
ём|взяток
еман|козел|яман
еманжелинск|город
еманка|ямануха|коза|емануха|яманиха
емануха|еманка|яманиха|ямануха
ембель|рубанок|енбель
емейлы|электронные письма
емелиан|емельян|имя
емельян|емелиан|имя|емеля
Емельян|льстивый|Амельян|Емилиан|Емельянка|Емельяша|Емеля|Меля|Мелёха|Мелёша|Емелиан
емеля|болтливый|имя|емельян
Емеля|болтливый
емец|взяточник|негодяй|река
емкo|ёмкo
емкая|ёмкая
емкие|ёмкие
емкий|широкий|содержательный|укладистый|поместительный|уемистый|вместительный|вместимый|обширный|ёмкий|сверхъемкий
емким|ёмким
емкими|ёмкими
емких|ёмких
емко|содержательно
емкого|ёмкого
емкое|ёмкое
емкой|ёмкой
емком|ёмком
емкому|ёмкому
емкостнo|ёмкостнo
емкостная|ёмкостная
емкостно|уместительный
емкостного|ёмкостного
емкостное|ёмкостное
емкостной|уемистый|емкостный|двухемкостной|ёмкостной
емкостном|ёмкостном
емкостному|ёмкостному
емкостную|ёмкостную
емкостные|ёмкостные
емкостный|ёмкостный|вместительный|уемистый|уместительный|емкостной|двухемкостной
емкостным|ёмкостным
емкостными|ёмкостными
емкостных|ёмкостных
емкость|баллон|сборник|бак|канистра|цистерна|резервуар|танк|урна|лоток|ловушка|параша|бидон|микрофон|амбар|вместимость|содержательность|вместительность|вместилище|гидроемкость|кабелеемкость|поместительность|пароемкость|отстойник|дежа|укладистость|акратофор|сосуд|амбараотстойник|зумпф|гидропульт|грузоемкость|криоемкость|нефтеемкость|диссольвер|уместительность|котел|пневмоемкость|кег|жбан|братина|баклага|бурак|бутылка|кеги|варяк|бочка|ведро|фляга|кашло|ёмкость|фиал|яндова|кокотница|кадка|медница|таз|корыто
ёмкость|емкость
емкость рынка|объем рынка
емкость с пастой|жопа|задница|зад
емкую|ёмкую
ё-мое|ё-клмн
ему в руки|в его руки
ему ведь|ведь ему
ему ещё далеко|он еще не дорос
ему и карты в руки|старый зверь|собаку съел|наторелый|бывать в переделках|пройти огонь и воду|умудренный опытом|информированный|пройти огонь|воду и медные трубы|старый воробей|много повидал на своем веку|глаз набит|ученый|стреляная птица|побывать в переделках|видать виды|травленый зверь|из семи печей хлеб едал|бывалый|видалый|зубр|осведомленный|тертый|умудренный|большой опыт за плечами|умелый|глаз наметан|стреляный воробей|все ходы и выходы знает|все ходы-выходы знает|травленый волк|стреляный зверь|не из одной печи хлеб едал|это по его части|грамотный|тертый калач|многоопытный|дока|мастак|изощриться|спец|подготовленный|старый волк|знает все ходы и выходы|зубы съел|по его части|стреляный|искуситься|опытный|матерый|специалист|вооруженный знаниями|зубы проесть|искушенный|знакомый|знаток|знающий
ему лично|ему самому
ему палец покажи|смешливый|ему только палец покажи
ему предоставляется возможность|он может
ему предоставлялась возможность|он мог
ему самому|ему лично
емуранка|емуранчик
емуранчик|тушканчик|грызун|емуранка
емуривший|ямуривший
емурина|омут|омутина
емчуг|пена|сор|емчуга
емчуга|налет|ямчуга|емчуг|селитра
емшан|полынь|растение|евшан
емщик|съемщик|имщик|иматель
емщица|имщица|имательница|съемщица
емь|лапа
емьева|река
е-мэйл|и-мэйл|мыло
енаит|минерал
енакиево|орджоникидзе|город|рыково
Енакиево|Орджоникидзе
енамин|соединение
енбель|рубанок|ембель
ендова|ящик|яма|посуда|котловина|яндова|разжелобок|сосуд|ендовка|кандея|муторма|желоб|залив
ендовище|впадина
ендовка|ящик|ендова
енисей|река
енисейск|город
-енк-|малый
енколпий|панагия|ковчежец
енный|хороший|дельный|умный
енол|соединение
енот|хищник|коати|полоскун|енот-полоскун|млекопитающее
енотаевка|судно
енотка|шуба
енот-полоскун|енот
Енох|воспитатель|учитель
еноха|добряк|простак
енцит|минерал
енцшит|минерал
епакта|число
епанечка|безрукавка|епанча
епанечник|копытень|епанча
епанча|шубка|плащ|одежда|мантия|накидка|японча|епанечка|епанечник|растение|копытень|япанча
епарх|управитель
епархиалка|воспитанница
епархия|область|край|епископия
епаршеский|епарший
епарший|епаршеский
епендит|одежда
епигонатий|палица
епископ|митрополит|патрик|архиепископ|духовенство|бискуп|примас|иерарх
епископальнo|англиканскo
епископальная|англиканская
епископального|англиканского
епископальное|англиканское
всего мира|целого мира
целого мира|всего мира
едва ли|почти ли
своя дача|собственная дача
дачное строительство|постройка дач
рисует|пишет
с тяжёлым|с очень тяжёлым
дача|дача
не согласится|будет не согласен
самостоятельно|самостоятельно
альтернатива|другой вариант
продавая|желая продать
или даже|или же
сделку|сделку